# Glossary in tab-separated format -*- coding: utf-8 -*-
whitespace	caractère d'espacement	espace, tabulation, retour à la ligne
language pair	paire de langues	Traduction la plus usuelle dans le secteur de la traduction
active segment	segment actuel
stemming	lemmatisation	OmegaT
community manager	gestionnaire de communauté	DB
team project	projet en équipe
mapping	mise en correspondance
Preference	Préférence
for details.	pour en savoir plus.
writable	modifiable
directory	dossier
Pane	volet
Tools	Outils	menu principal
preference	paramètre
folder	dossier
appendix	annexe
Shortcut	Raccourcis
dialog	boîte de dialogue	also called a dialogue box
carriage return character	caractère retour chariot	also CR
backslash	barre oblique inversée
Key	Touche	Léo
blank	vide
user manual	manuel d'utilisation	Pour écriture épicène
Tag shortcuts	balises abrégées
Tooltips	Infobulles
remote repository	dépôt distant	anciennement "référentiel distant"
credentials	identifiants
writable glossary	glossaire modifiable	après discussion le 20/03/2023
translator	traductaire	terme épicène
VCS	logiciel de gestion de version
version control system	logiciel de gestion de version
Notepad	Bloc-note	Nom de la fenêtre, nom du menu qui y va
Create Glossary Entry	Créer une entrée de glossaire	UI
Edit	Édition	UI
API key	clé d'API	https://www.ibm.com/docs/fr/control-desk/7.6.1.2?topic=components-api-keys
Sets	Configurations	règles de segmentation
you	vous	test pour l'apostrophe
highlight	surligner	antidote
Select	Choisir
Embeddings	Intégrations	Léo
offline mode	mode hors ligne
Cross-platform	Multiplateforme
username	identifiant
user interface	interface	interface graphique
user group	groupe de soutien
