browser	navigateur	
dock	ancrer	
enable	activer	
font	police	
invalid	non valide	
librairie	bibliothèque	
location	emplacement	
MB	Mo	
OK	OK	
pattern	masque	(fichiers ou expression régulière)
press	appuyer	
redo	répéter	
remove	supprimer	
save	enregistrer	
search	rechercher	
setup	configuration	
supported	pris en charge
tag	balise
unsupported	non pris en charge
warning	avertissement
Web browser	navigateur Web
